1111111111111111111111111111111111111111111111111111111111111111111111111111111111111111111111111111
1111111111111111111111111111111111111111111111111111111111111111111111111111111111111111111111111111
1111111111111111111111111111111111111111111111111111111111111111111111111111111111111111111111111111
1111111111111111111111111111111111111111111111111111111111111111111111111111111111111111111111111111
1111111111111111111111111111111111111111111111111111111111111111111111111111111111111111111111111111
1111111111111111111111111111111111111111111111111111111111111111111111111111111111111111111111111111
1111111111111111111111111111111111111111111111111111111111111111111111111111111111111111111111111111
1111111111111111111111111111111111111111111111111111111111111111111111111111111111111111111111111111
1111111111111111111111111111111111111111111111111111111111111111111111111111111111111111111111111111
1111111111111111111111111111111111111111111111111111111111111111111111111111111111111111111111111111
1111111111111341111111111111111111111111111111111111111111111111111111111111111111111111111111111111
111111111112;6<4111111111111111111111111111111111111111111111111111111111111111111111111111111111111
11111111123;666<341111111111111111111111111111111111111111111111111111111111111111111111111111111111
1111111115666666671111111111111111111111111111111111111111111111111111111111111111111111111111111111
111111111;666666671111111111111111111111111111111111111111111111111111111111111111111111111111111111
1111111156666666671111111111111111111111111111111111111111111111111111111111111111111111111111111111
111111115666666667111111111?@@@@@@@@A111111111111111111111111111111111111111111111111111111111111111
111111118>666666671111111?@HCCCCCCCCI@A1111111111111111111111111111111111111111111111111111111111111
1111111118>66666=:111111?HCCCCCCCCCCCCI1111111111111111111111111111111111111111111111111111111111111
11111111118>66=911111111BCCCCCCCCCCCCCCD111111111111111111111111111111111111111111111111111111111111
111111111115667111111111BCCCJKCJFFFKCCCIA11111111111111111111111111111111111111111111111111111111111
111111111115667111111111BCCCIHCD111BCCCCD11111111111111111111111111111111111111111111111111111111111
11111111112;667111111111BCCCCCCIA11BCCCCD11111111111111111111111111111111111111111111111111111111111
111111111156667111111111BCCCCCCCD1?HCCCJ111111111111111111123333334111111111111111111111111111111111
111111111156667111111111BCCCCCCCI@HCCCCD1111111111111111112;666666<341111111111111111111111111111111
111111111156667111111111EKCCCCCCCCCCCCJG111111111111111112;666666666<3411111111111111111111111111111
1111111111566671111111111EFKCCCCCCCCCCD111111111111111112;666666666666<41111111111111111111111111111
1111111111566671111111111?@HCCCCCCCJFFG11111111111111111566666666666666<4111111111111111111111111111
111111111156667111111111?HCCCCCCCCCD111111111111111111115666666666666666<411111111111111111111111111
11111111115666711111111?HCCCCCCCCCCD1111111111111111111156666666666666666711111111111111111111111111
11111111115666<41111111BCCCCCCCCCJFG111111111111111111118>666666666666666711111111111111111111111111
11111111115666671111111BCCCCCCJFFG111111111111111111111115666666666666666<41111111111111111111111111
11111111115666671111111BCCCCJFG11111111111111111111111112;666666666666666671111111111111111111111111
11111111115666671111111EFFFFG111111111111111111111111112;6666666666666666671111111111111111111111111
11111111118>6667111111111111111111111111111111111111112;66666666666666666=:1111111111111111111111111
111111111115666<41111111111111111111111111111111111123;666666=99>666=9999:11111111111111111111111111
1111111111156666<41111111111111111111111111111111112;6666666=:118999:1111111111111111111111111111111
11111111111566666<411111111111111111111111111111112;666666=9:111111111111111111111111111111111111111
111111111118>66666<4111111111111111111111111111123;666666=:11111111111111111111111111111111111111111
1111111111115666666<4111111111111111111111111123;6666666=:111111111111111111111111111111111111111111
1111111111118>666666<3341111111111111111111123;66666666=:1111111111111111111111111111111111111111111
11111111111115666666666<34111111111111111233;666666666=:11111111111111111111111111111111111111111111
1111111111111899>66666666<333333333333333;66666666666=:111111111111111111111111111111111111111111111
1111111111111111899>66666666666666666666666666666=999:1111111111111111111111111111111111111111111111
1111111111111111111899>666666666666666666666666=9111111111111111111111111111111111111111111111111111
11111111111111111111118999>6666666666666666666671111111111111111111111111111111111111111111111111111
1111111111111111111111111189999>66666666666666=:1111111111111111111111111111111111111111111111111111
1111111111111111111111111111111899999>66666666<41111111111111111111111111111111111111111111111111111
11111111111111111111111111111111111118999>66666<4111111111111111111111111111111111111111111111111111
111111111111111111111111111111111111111118>66666<333411111111111111111111111111111111111111112333333
1111111111111111111111111111111111111111118>66666666<3333411111111111111111111111111111111233;666666
111111111111111111111111111111111111111111189>66666666666<33333341111111111111111111111123;666666666
1111111111111111111111111111111111111111111118>66666666666666666<33333333333333333333333;66666666666
1111111111111111111111111111111111111111111111899999>66666666666666666666666666666666666666666666666
111111111111111111111111111111111111111111111111111189999>666666666666666666666666666666666666666=99
111111111111111111111111111111111111111111111111111111111899>666666666666666666666666666666666=99:11
111111111111111111111111111111111111111111111111111111111111899999>6666666666666666=9999999999:11111
11111111111111111111111111111111111111111111111111111111111111111189999999999999999:1111111111111111
1111111111111111111111111111111111111111111111111111111111111111111111111111111111111111111111111111
1111111111111111111111111111111111111111111111111111111111111111111111111111111111111111111111111111
1111111111111111111111111111111111111111111111111111111111111111111111111111111111111111111111111111
1111111111111111111111111111111111111111111111111111111111111111111111111111111111111111111111111111
1111111111111111111111111111111111111111111111111111111111111111111111111111111111111111111111111111
1111111111111111111111111111111111111111111111111111111111111111111111111111111111111111111111111111
1111111111111111111111111111111111111111111111111111111111111111111111111111111111111111111111111111
111111111111111111111111111111111?@@@@A1111111111111111111111111111111111111111111111111111111111111
11111111111111111111111111111111?HCCCCIA111111111111111111111111111111111111111111111111111111111111
1111111111111111111111111111111?HCCCCCCIA11111111111111111111111111111111111111111111111111111111111
1111111111111111111111111111111BCCCCCCCCIA1111111111111111111111111111111111111111111111111111111111
1111111111111111111111111111111BCCCCCCCCCD1111111111111111111111111111111111111111111111111111111111
1111111111111111111111111111111BCCCCCCCCCD1111111111111111111111111111111111111111111111111111111111
1111111111111111111111111111111BCCCCCCCCCD1111111111111111111111111111111111111111111111111111111111
1111111111111111111111111111111BCCCCCCCCCD1111111111111111111111111111111111111111111111111111111111
1111111111111111111111111111111EKCCCCCCCJG1111111111111111111111111111111111111111111111111111111111
11111111111111111111111111111111EFKCCCCJG11111111111111111111111111111111111111111111111111111111111
1111111111111111111111111111111111EFFFFG111111111111111111111111111111111111111111111111111111111111
1111111111111111111111111111111111111111111111111111111111111111111111111111111111111111111111111111
1111111111111111111111111111111111111111111111111111111111111111111111111111111111111111111111111111
1111111111111111111111111111111111111111111111111111111111111111111111111111111111111111111111111111
1111111111111111111111111111111111111111111111111111111111111111111111111111111111111111111111111111
1111111111111111111111111111111111111111111111111111111111111111111111111111111111111111111111111111
1111111111111111111111111111111111111111111111111111111111111111111111111111111111111111111111111111
1111111111111111111111111111111111111111111111111111111111111111111111111111111111111111111111111111
1111111111111111111111111111111111111111111111111111111111111111111111111111111111111111111111111111
1111111111111111111111111111111111111111111111111111111111111111111111111111111111111111111111111111
1111111111111111111111111111111111111111111111111111111111111111111111111111111111111111111111111111
1111111111111111111111111111111111111111111111111111111111111111111111111111111111111111111111111111
1111111111111111111111111111111111111111111111111111111111111111111111111111111111111111111111111111
1111111111111111111111111111111111111111111111111111111111111111111111111111111111111111111111111111
1111111111111111111111111111111111111111111111111111111111111111111111111111111111111111111111111111
1111111111111111111111111111111111111111111111111111111111111111111111111111111111111111111111111111
1111111111111111111111111111111111111111111111111111111111111111111111111111111111111111111111111111
1111111111111111111111111111111111111111111111111111111111111111111111111111111111111111111111111111
1111111111111111111111111111111111111111111111111111111111111111111111111111111111111111111111111111
1111111111111111111111111111111111111111111111111111111111111111111111111111111111111111111111111111
1111111111111111111111111111111111111111111111111111111111111111111111111111111111111111111111111111
1111111111111111111111111111111111111111111111111111111111111111111111111111111111111111111111111111
1111111111111111111111111111111111111111111111111111111111111111111111111111111111111111111111111111
1111111111111111111111111111111111111111111111111111111111111111111111111111111111111111111111111111
1111111111111111111111111111111111111111111111111111111111111111111111111111111111111111111111111111
